25.000
Mars.
Crveni planet.
Rakete su došle do njegove | suhe stjenovite površine,
ali ljudi nisu.
Prostor izmeðu Zemlje i Marsa | opasan je za putovanje.
I èestice meteorske prašine | mogu raznijeti svemirski brod.
Taj put æe iziskivati | neviðenu ljudsku hrabrost
i najbistrije znanstvenike, | ali poèetkom 21. stoljeæa
mogli bismo poslati | astronaute na susjedni planet.
Kontrola, Explorer 1 | je sletio.
Put je dugaèak | 400 milijuna km.
Trajao bi 2,5 g., ukljuèujuæi | 18 mjeseci na površini Marsa.
To je najveæa pustolovina | od slijetanja ljudi na Mjesec.
Ovoga je puta odredište Mars.
 ODREDIŠTE MARS 
Velièinom kao treæina Zemlje, | Mars ima vulkane
širine države Missouri, | a najviša planina
tri puta je viša | od Mount Everesta.
Neke rijeène doline su široke | koliko je dug Grand Canyon.
Gravitacija je upola manja | od Zemljine.
Dan je dulji nekoliko minuta, | a godina je dvostruko dulja.
Tako je hladno | da je sva voda zarobljena
u polarnim ledenim kapama | ili smrznuta ispod površine.
Probno paljenje motora u 6...
Za veæinu nas, misija na Mars | znanstvena je fantastika,
ali zapravo smo | gotovo spremni za kretanje.
Vjerujem da æe poèetkom | 21. stoljeæa
Daniel Goldin | Administrator NASA-e
ljudi zakoraèiti Marsom. | Svi tehnološki elementi
Bob Zubrin | Pioneer Astronautics
koji su potrebni za tu misiju | zapravo veæ postoje.
Mars je mjesto | na kojemu možemo živjeti
Carol Stoker, | Istraživaèki centar NASA Ames
i po tome se | potpuno razlikuje
od svih ostalih planeta | Sunèeva sustava.
Bit æe djece, Marsovaca | druge generacije
Gene Cernan | Astronaut Apolla
koji æe govoriti, | 'Hej, moji djed i baka,
u n-tomu su stoljeæu | došli sa Zemlje.
Postoji tehnologija | za put na Mars.
Još od Apolla, nekolicina | entuzijasta sanja taj san
i smišlja kreativne naèine | preživljavanja u svemiru.
No uspjeh ovisi o nekoliko | zapanjujuæih otkriæa.
Nove tehnologije mogu smanjiti | troškove misije za 90 posto
i skratiti putovanje za pola. | Odbrojavanje je poèelo.
Poèetkom 21. stoljeæa | mogla bi biti spremna
prva ljudska misija na Mars. | Cilj æe joj biti
traženje tragova života | na Marsu.
Takoðer æe tražiti | dragocjene minerale
i provjeriti moguænost | naseljavanja ljudi.
Planirani poèetak puta je kad | Zemlja prolazi kraj Marsa,
što se dogaða svakih | 26 mjeseci.
Pogurnuti Marsovom | gravitacijom, trebat æe im
manje goriva, a na odredištu | æe biti za samo 6 mjeseci.
Jedan od projekata predviða | marsovsku letjelicu
promjera 27 m, | podijeljenu na 2 palube.
Na gornjoj palubi su | odaje posade,
a služit æe im i kao | naseobina na Marsu.
Svjetsko zanimanje za Mars | nikada nije bilo ovoliko,
otkad je NASA održala | konferenciju za tisak
kako bi objavila pronalazak | ovoga maloga meteora.
Prije 16 milijuna godina
Odbijen od površine Marsa | prije mnogo milijuna godina,
sluèajno je pao na Zemlju. | U njemu su znanstvenici
pronašli minerale koji su | mogli nastati jedino u vodi.
Osim minerala, | bilo je struktura
koje su mogla stvoriti biæa | nalik bakterijama.
Najjednostavnije objašnjenje | kaže da su to ostaci
života na Marsu. | Taj meteor, i još jedan
koji su pronašli | britanski znanstvenici,
snažni su dokazi | da možda nismo sami u svemiru,
ali nisu ih svi | tako protumaèili.
Postoji li doista | život na Marsu?
To je prastaro pitanje koje | stoljeæima muèi znanstvenike
i potièe raspravu o misijama | s posadom ili bez nje.
Javila se ideja da bismo | možda trebali poslati ljude
Daniel Goldin | Administrator NASA-e
i pokušati shvatiti | povijest života na Marsu.
Robote šaljemo kako bismo | otprilike upoznali planet
i pronašli mjesta kamo bismo | mogli poslati ljude.
Kad pošaljemo robote | na površinu,
želimo da se vrate s uzorcima | kako bismo imali još dokaza.
A ako su dokazi nepobitni, | onda šaljemo ljude.
Carol Stoker iz NASA-inoga | istraživaèkoga centra Ames
provela je veæinu karijere | pokušavajuæi olakšati
istraživanje Marsa | vozilima 'roverima'.
Do 2006., èak 6 vozila | razlièitih velièina
trebala bi sletjeti na Mars | i poslati podatke o površini.
Jedan od najboljih je | ruski Marssakod
koji može putovati | stotinama kilometara.
No daljinski nadzor | nad roverima je mukotrpan.
Slike i naredbe mogu putovati | i 20 minuta u jednomu smjeru.
Kako bi zaobišla | vremensku razliku,
Carol Stoker je smislila | sustav prividne stvarnosti
kojim roveri mogu voziti | bez èekanja potvrde
i skupljati podatke potrebne | za odabir mjesta
za slijetanje posade, | ali mala je vjerojatnost
da æe vozila | na daljinsko upravljanje
sama moæi odgovoriti na | znaèajna pitanja o Marsu.
Podrobnim istraživanjem | površine æe se uvijek
teško upravljati sa Zemlje | ili automatizirati.
Na primjer, recimo | da ste pronašli nešto
što bi mogao biti | dokaz života na Marsu.
Recimo da ste pronašli fosil.
Èak i s trenutaènim TV-slikama | i izravnim upravljanjem,
tzv. Teleoperacijski sustav | koji bi astronauti mogli
koristiti iz postaje na Marsu, | èak je promatranje
zanimljivoga kamena | dovoljno složeno.
Postavljanje kamere | u pravi položaj
iziskuje mnogo | pojedinaènih naredbi.
Nakon svake naredbe, | vozaè mora prièekati
da vidi gdje je ruka, a onda | odluèiti o iduæemu pokretu.
Dodajte kašnjenje od 20 min | i vidite kako bi uzimanje
uzorka stijene èekiæem geologa | bili krajnje mukotrpno.
Mogli biste trebati mjesec, | ili èak godinu dana,
da sa Zemlje uèinite | ono što biste obavili
za sat vremena | da ste ondje, znate,
bilo uživo | ili teleoperacijom.
Astronaut šatla | i zaljubljenik u Mars
Tom Jones dijeli | Stokerièino mišljenje.
Na pitanja o porijeklu | života na Marsu
jedino možemo odgovoriti | ako odemo onamo
i detaljno ga istražimo. | Možda æe nam trebati
mikroskopi i èaèkalice | da pronaðemo odgovore
u marsovskim fosilima. | Možda æemo morati
kopati ispod površine. | Ništa od toga se ne može
pošteno obaviti slanjem | jednostavnih robota na Mars.
Zato su potrebni | živi istraživaèi
i njihovi laboratoriji | te dugotrajni ostanak
kako bismo dobili odgovore.
Nièija strast glede slanja | ljudi na Mars
se ne može mjeriti sa strašæu | skupine znanstvenika
koja se nazvala | Mars Underground.
Od 1981. održavaju | tiskovne konferencije
da skepticima predoèe | izvedivost takve misije.
Oni æe odletjeti na Mars. | Letjet æe u skupini
s jednom letjelicom | za povratak na Zemlju,
koja im je prièuva, | a ako je neæe trebati,
njome æe se moæi sletjeti | na drugome mjestu. Ondje...
Bob Zubrin, jedan od | najistaknutijih èlanova
Mars Undergrounda, | nepresušan je izvor ideja
o smanjenju troškova | ljudske misije na Mars.
Najvažnija osoba za misiju | je mehanièar,
onaj koji može popraviti | sustave svemirskoga broda
jer o tome ovise svi životi | i uspješnost misije.
Drugi važni struènjaci | terenski su znanstvenici
jer oni izvršavaju | koncept misije.
Zato predlažem dvoje | jednih i dvoje drugih.
Ako dodate petoga èlana, | i to lijeènika,
poveæali ste masu misije | za 20 posto.
Zamisao je da je | podijeljena na dvije razine.
'60-tih, tijekom | programa Apollo,
nije se pitalo za novac | jer se radilo o utrci
s Rusima na Mjesec, | ali po završetku hladnoga rata
bit æe teško financirati | misiju na Mars.
Ne smijemo se pretvoriti | u hrpu lijenih inženjera
i uredskih projektanata misije | te reæi da su naš loš ustroj
i skupi projekti u redu | jer æemo tražiti više novaca
od javnosti, a oni æe time | biti oduševljeni.
Moramo javnosti dati visoku | vrijednost za uložene novce.
Na Mars se idemo naseliti.
Cilj ovogodišnjega sastanka je | osmišljanje pet misija na Mars
koje æe sve zajedno koštati | 32 milijarde dolara.
Kad bi Sjedinjene Države | platile pola iznosa,
a meðunarodna zajednica | ostatak,
to bi iznosilo | dvije milijarde na godinu.
Što se tièe razloga iz kojega | onamo treba iæi,
svi u ekipi Mars Underground | imaju dobre razloge.
Ja sam biologinja
Penelope Boston | Mikrobiologinja
i zato želim znati sve | o životu u svemiru,
a planet koji najvjerojatnije | u našemu Sunèevomu sustavu
može imati tragove života, | iz sadašnjosti ili prošlosti,
jest Mars.
Je li bilo života
Chris McKay | NASA, Istraživaèki centar Ames
dok je u prošlosti bilo vode? | Dok je bio poput Zemlje?
Je li ondje sada održiv | život, naroèito ljudski?
Bi li se na Mars mogao | prenijeti život
na naèin da planet dobije | Zemlji slièan okoliš?
Mars je novi svijet.
Bob Zubrin, | Pioneer Astronautics
Mars èeka ljude da doðu, | istraže, otkriju i nasele ga.
Mjesto gdje se može osnovati | nova civilizacija.
Mars je mjesto kamo možemo | otiæi živjeti,
Carol Stoker | NASA, Istraživaèki centar Ames
i to ga èini drukèijim
i od kojega drugoga planeta | u našemu Sunèevomu sustavu.
Mnogi od voða Mars | Undergrounda su se upoznali
kao studenti na Sveuèilištu | Colorada u Boulderu.
S vremena na vrijeme su se | okupljali na opservatoriju
i sanjali o istraživanju i | nastanjivanju drugih planeta.
Gledajuæi u noæno nebo,
èesto su teleskop usmjeravali | prema Marsu,
kao i jedan od amerièkih | najslavnijih astronoma,
Percival Lowell.
Još 1890-tih, Lowell je rabio | svoj moæni teleskop
kako bi uhvatio neke od prvih | slika crvenoga planeta.
Promatrajuæi intenzivne | promjene klime,
i blijede obrise koji su | križali površinu,
Lowell je zakljuèio | da je Mars prekriven
složenom mrežom kanala koje je | izgradila oèajna civilizacija
koja se pokušavala nositi | s poplavama i sušama.
Lowell nije jedini imao viziju | marsovske civilizacije,
nego je njegov rad potaknuo | prvi val znanstvene fantastike
o tome | kako su Marsovci izgledali
i o našemu prvomu susretu | s njima.
Prièe o izvanzemaljcima | zaokupile su maštu
naraštaja djece, | od kojih su neka postala
dijelom Mars Undergrounda.
Kao djeèak èitao sam puno | znanstvene fantastike.
Bob Zubrin, | Pioneer Astronautics
Bilo je uzbudljivih prièa o | tome kako bi ljudi tamo otišli
i imali pustolovine. Želja | da budem dio te pustolovine
imala je veliku ulogu u odluci | da postanem znanstvenik.
U mnogo pogleda, | te prièe su bile netoène.
Katkad su tehnièki detalji | bilo potpuno ludi,
a u gotovo svakomu pogledu | njihovo je razumijevanje
o tome kako su Mars | i drugi planeti izgledali,
bilo jako daleko od istine.
Ali u osnovi, mislim da su | u sebi sadržavali više istine
nego neistine, | jer su prikazivali te planete
kao prave svjetove.
Moje zanimanje za odlazak | na Mars
Carol Stoker | NASA, Istraživaèki centar Ames
zapravo je zapoèelo snom | koji sam usnula kao dijete.
Bilo mi je oko 8 godina | i bila sam kod bake i djeda
na praznicima. Pet ili šest | noæi za redom sam sanjala
san u nastavcima | o odlasku na Mars.
San je zapoèeo ulaskom | u raketu i odlaskom na Mars,
a onda se svašta dogaðalo | dok sam, koliko se sjeæam,
bila na Marsu | otprilike dvije godine.
Ondje sam upoznala razne | ljude, èak i svojega muža,
s kojim sam se vratila | na Zemlju na kraju sna.
Od tada u potpunosti vjerujem | da æu otiæi na Mars.
Amerièki svemirski brodovi su | došli blizu Marsa 6 puta
izmeðu 1964. i 1976. godine.
Viking 1 i 2 èak su | sletjeli na površinu.
Ishod je bio spektakularan.
Poslali su slike | natrag na Zemlju.
Slike planeta koji je | nevjerojatno slièan našem.
Kako bi provjerili | ima li na Marsu života,
svaki je Viking | pokupio uzorak tla.
Od èetiri testa kojima su | uzorci podvrgnuti,
tri su bila pozitivna, | ali rezultati èetvrtoga,
najvažnijega testa | bili su negativni.
Pitanja su ostala | neodgovorena.
Fotografije iz orbite | koje su pokazale
èudne paralelne linije, | i stijenu s otiskom lica,
pokrenule su nagaðanja | o izgubljenoj civilizaciji.
Ali ovakve slike neèega što | izgleda kao jutarnji mraz
najviše su zaintrigirale | znanstvenike.
Stara korita rijeka ukazuju | da je na Marsu bilo toplije
i da je bilo tekuæe vode.
Ledene polarne kape su dokaz | da vode još uvijek ima.
Fotografije su nam pokazale | pravi Mars.
Ne kako smo ga zamišljali, | s kanalima i civilizacijama,
ali su nam pokazale | da je jednom davno
Chris McKay | NASA, Istraživaèki centar Ames
Mars bio drukèiji svijet.
Vlažan, aktivan, | možda i životan svijet.
Saznanje da su u Sunèevomu | sustavu jednom postojala
dva planeta poput Zemlje | nam je još uvijek
motivacija | za istraživanje Marsa.
Mars Explorer 1, | spremni ste za TMI.
Nakon provjere svih sustava | na svemirskomu brodu,
posada zadnji put gleda Zemlju | dok se sprema na odlazak
iz relativno sigurne | Zemljine orbite.
Razumijem, trans Mars | ubrizgavanje, kreni.
30 sekunda do paljenja.
Za deset minuta æe sagorjeti | sve gorivo u gornjemu dijelu
i zapoèet æe dugu, klizeæu | vožnju prema crvenomu planetu.
To je zadnji put da kontrola | leta nadgleda manevriranje.
Uskoro æe svemirski brod biti | izvan dosega komunikacije.
Motori spremni.
Pet, èetiri, tri, dva, jedan.
Kraj paljenja je prvi korak
šesteromjeseènoga putovanja | na Mars.
Uspjeh Marsu.
Hej.
Sad kad je gorivo iz gornjega | dijela potrošeno,
došli su do mjesta s kojega | nema povratka.
Capcom, sada æu siæi s LEM-a.
Ovo je mali korak za èovjeka, | ali ogroman za èovjeèanstvo.
Kad je Apollo 11 sletio na | Mjesec 1969., odlazak na Mars
više se nije èinio | kao znanstvena fantastika
i cijeli je svijet | bio na nogama.
Kad sam se vratio, | ljudi su mi prilazili
i govorili, 'Hoæu ti reæi gdje | sam bio, dok si ti bio gore',
ponovno, ponovno i ponovno.
Buzz Aldrin | Astronaut Apolla
Životi ljudi na ovomu planetu | su se promijenili,
jer su doživjeli nešto što se | nikad prije nije dogodilo.
Bili su svjedoci povijesti | i to su doživjeli.
Prekrasno. Ovo je sigurno | jedan od najveæih
trenutaka mojega života. | Jamèim vam.
Do šestoga slijetanja na | Mjesec amerièki astronauti
postali su struènjaci | u istraživanju planeta.
Uživaj.
Kako bi tehnologija radila, | kretala se i preživjela
izvan svemirskoga broda, | testirana je i profinjena.
Ali ljudska putovanja izvan | Zemlje su završila Apollom 17.
Kad je Apollo završio, | mislim da smo tehnološki
bili na pragu razvijanja | moguænosti odlaska na Mars.
Zapravo, kad smo se vratili, | zakljuèili smo
da æemo do kraja stoljeæa | putovati na Mars.
Ali nismo mogli podiæi | duh naroda,
Gene Cernan | Atronaut Apolla
da se krene dalje | i nastavi truditi.
Mislim da su ljudi tada | u biti, i mrsko mi je to reæi,
ali mislim da su skoro | izgubili zanimanje.
Mislim da smo tada vjerojatno | preoptimistièno osjeæali,
'Pustite nas na Mars, | možemo mi i to.'
U meðuvremenu smo saznali | da je to malo složenije.
Na 20. obljetnicu prvoga | slijetanja na Mjesec,
Mars je izgledao | kao sljedeæi veliki izazov.
Od Kolumbovih putovanja,
preko Oregonskoga puta, | do puta na sam Mjesec,
povijest nam je pokazala | da nikada nismo izgubili
kad smo pomicali | naše granice.
Moramo se ponovno posvetiti | sustavno podržanomu programu
ljudskoga istraživanja | Sunèevoga sustava,
ali i misiji na Mars | s ljudskom posadom.
NASA-in plan je zahtijevao | lansiranje tona materijala,
goriva i zaliha u orbitu, | na brojnim raketama,
koje æe se onda sastavljati | u svemiru.
Ali plan je uskoro | naletio na probleme.
Problem s NASA-inim planom | bio je što se morao izgraditi
ogroman svemirski brod, | jer su na Mars morali ponijeti
sve gorivo i kisik koji im je | trebao da se vrate kuæi.
To je iznosilo 80%% mase | koju su slali na Mars,
i nikad ništa nije ni krenulo | jer je bilo preskupo.
Procijenjeni trošak je bio | 450 milijarda dolara,
što je Kongres | odbio financirati,
a program je bio obustavljen.
Kako bi se misija nastavila, | Bob Zubrin i njegovi inženjeri
Lockheed-Martin astronautike, | smislili su naèin
proizvodnje goriva | za povratak s Marsa.
Cilj im je bio iskoristiti | atmosferu Marsa kao
sirovi materijal, što se moglo | simulirati u laboratoriju.
Da bi pretvorili | atmosferu u gorivo,
odabrali su jednostavnu | kemijsku reakciju
za koju se zna | veæ duže od stoljeæa.
Izgradili su prototip da bi | provjerili kako funkcionira.
Jedna je komora ispunjena | apsorpcijskim prahom
koji može upiti ugljièni | dioksid iz atmosfere Marsa.
U drugoj komori, plin se | miješa s malo vodika,
jedinom sirovinom koju bi | morali donijeti sa Zemlje.
Oni reagiraju stvarajuæi | metan, prirodni plin
koji je odlièan kao gorivo, | i vodu.
Voda se šalje u treæu komoru | gdje se elektrolizom
stvara kisik potreban za | izgaranje metanskoga goriva.
Ovakva mala sprava može | proizvesti sve gorivo i kisik
potrebno za povratak s Marsa i | napajanje površinskoga vozila.
Svaki kilogram vodika koji | bi ponijeli sa Zemlje
stvorio bi 12 kilograma | metana i kisika,
što bi astronautima omoguæilo | da žive od tamošnjih resursa.
Umjesto lansiranja svemirskoga | broda od 1000 tona
u Zemljinu orbitu, potrebno je | lansirati možda 200 tona,
a to se možda može uèiniti | u dva lansiranja po 100 tona.
Imali smo rakete koje su | to mogle uèiniti prije 30 g.
Ako se prihvati ovaj pristup | Marsu, s tamošnjim resursima,
to u osnovi znaèi da misiju | možemo ostvariti
sadašnjom tehnologijom, | koju imamo veæ desetljeæima.
Rakete Saturn 5 kojima je | lansiran Apollo '60-tih,
a svaka može nositi | preko 140 tona,
idealne su za lansiranje | marsovske letjelice
u Zemljinu orbitu. | Ali jedine rakete Saturn 5
danas su muzejski primjerci | u svemirskim centrima NASA-e
pa bi trebalo | ponovno pokrenuti proizvodnju.
Alternativa su malo slabije | ruske rakete Energija.
Testirane su dvaput, | a tvornica još postoji.
Ili bi se raketa šatla mogla | pretvoriti u raketu
za marsovsku letjelicu | koja bi se iz 2, 3 dijela
složila u svemiru.
Malena višekratna raketa | koju NASA trenutaèno razvija
iziskivala bi više letova, | ali bi mogla smanjiti trošak.
Ista raketa višega stupnja | kojom je Apollo išao na Mjesec
mogla bi poslužiti za put | od Zemljine orbite do Marsa.
Zubrin stroj bi mogao preuzeti | pri povratku s Marsa.
On bi ostvario svaku misiju | na Mars u 2 lansiranja
planom zvanim Mars Direct.
Prvim lansiranjem æemo na Mars | poslati letjelicu bez posade
koja æe služiti | za povratak na Zemlju.
To je mali raketni brod | kojom æe se letjeti
s Marsa na Zemlju | s posadom od 4 astronauta,
ali nitko se trenutaèno | u njoj ne nalazi.
Ide na Mars bez goriva. | Spremnici za gorivo su prazni,
a kad sleti na Mars, | stvorit æe gorivo i kisik
koji joj treba za povratak. | Trebat æe 5 do 10 mjeseci
za stvaranje goriva. Naravno, | to æe se pratiti sa Zemlje
pa æe se puno prije iduæe | moguænosti za lansiranje
znati imamo li letjelicu | opskrbljenu gorivom
za povratak na Zemlju, | koja nas èeka na Marsu.
Posada æe se spustiti | nekoliko kilometara
od letjelice za povratak. | Kad doðe vrijeme za polazak,
napustit æe svoju letjelicu. | Mars Direct je ekonomièan
pa NASA-ini planeri misija | poput Johna Connollyja
prihvaæaju ideju | uz nekoliko manjih promjena.
Dobro jutro svima. | Zdravo, Johne.
Èujem da ne želite da ostanemo | na Marsu 500 dana,
nego da to traje kraæe. | Najveæa promjena je
postavljanje velike | letjelice za povratak
u Marsovu orbitu tako da, | kad posada poleti s Marsa,
može prijeæi u nešto | prostranije.
Ali osnovna ideja življenja | od dostupnih resursa
ukorijenila se je. | Ako æemo na Mars,
moramo poèeti misliti | poput osvajaèa Zapada.
John Connolly, | NASA Johnson svemirski centar
Morat æemo koristiti okruženje | da bismo preživjeli,
koliko god je moguæe. | Sjetite li se pionira
amerièkoga Zapada, oni nisu | tovarili Conestoga zaprege
drvima za gradnju brvnara, | nego su bilo gdje
gdje su došli | na Srednjemu Zapadu
sjekli drveæe na licu mjesta. | Živjeli su od zemlje.
Ondje su uzgajali hranu. | Nisu sve nosili sa sobom.
Da su ponijeli sve | što im je trebalo sa sobom,
ne bi se maknuli | dalje od Apalaèija.
Mi æemo na Mars | na isti naèin.
NASA-ini planeri traže | nove naèine za smanjenje
troškova misije na Mars. | Ako u tome uspiju
i ako robotske misije pruže | dovoljno znanstvenih razloga
za polazak, poduprt æe ih | ravnatelj NASA-e Dan Goldin.
To je moj najluði san. | Bilo bi to životno postignuæe
kad bih poveo ovu agenciju | izvan orbite Zemlje
do mjesta poput Marsa | i asteroida kako bismo lakše
razumjeli tko smo i što smo i | obogatili život ovoga planeta.
Kontrola, èujemo se?
Devetoga dana misije, Explorer | 1 je 16 milijuna km od kuæe.
Zemlja postaje | tek toèkica na nebu.
Do ove udaljenosti astronauti | su mogli imati
video konferencije sa Zemljom | dva puta na tjedan,
ali kako se udaljavaju, | kašnjenje æe se poveæavati
i postajati neobiènijim. | Puno sam razmišljao
o curenju u dnevnoj sobi | i mislim da bismo jednostavno
trebali zamijeniti | cijeli krov.
Sada kašnjenje iznosi | 5 sekunda.
Dobro, sutra æu | nazvati majstore.
Mogu obaviti posao za mjesec | dana, što je izvrsno.
A tu je netko tko ti želi | nešto reæi.
Nedostaješ mi. I meni.
Znanstvenici razvijaju | nove tehnologije
za recikliranje zraka i vode | tijekom misije na Mars.
Ukljuèujuæi stroj koji | pretvara urin u vodu za piæe.
Oprema se nalazi u trokatnoj | nepropusnoj komori.
Tijekom ljeta 1996., | 4 dobrovoljca podvrgli su
opremu prvomu pravomu | ispitu.
Zatvoreni mjesec dana, | oslonili su se na strojeve
koji su reciklirali njihove | izmete i proèišæavali
zrak i vodu. | Svi su ostali zdravi.
Ali NASA razvija još jedan | sustav za održanje života
koristeæi biljke | koje bi uspijevale na Marsu.
Kako bi ga testirao, | dobrovoljac Nigel Packem
živio je u brtvljenomu | prostoru dva tjedna.
Biljke su mu dale sav zrak | potreban za disanje.
Kako je Nigel koristio kisik | i stvarao ugljièni dioksid,
biljke su upijale ugljièni | dioksid i stvarale kisik.
Dok sam ovdje, | opet æu probati.
Pitanje je bilo mogu li èovjek | i biljka ostati u ravnoteži.
Raèunala su pratila zrak | u komori za život
i prilagoðavala kolièinu | svjetla za žitarice
kako bi se regulirala | proizvodnja kisika.
Biljke su se | izvrsno ponašale.
Vrlo brzo reagiraju | na moju prisutnost
i na promjene u mojemu | metabolièkomu proizvodu.
Na primjer, ako sjednem na | bicikl i vježbam pola sata,
biljke æe na to reagirati | vrlo, vrlo brzo.
Gotovo kao da znaju | da sam ovdje.
Sustav zasnovan na biljkama | prošao je prvi ispit.
NASA-in krajnji cilj je nešto | slièno pokušaju Biosfere 2
iz ranih '90-ih. | U tomu pokusu,
8 se znanstvenika zakljuèalo | na 2 g. Kako bi ispitali
izvedivost življenja u potpuno | izoliranomu umjetnomu svijetu.
Unutra su bile replike mnogih | glavnih Zemljinih ekosustava.
Ali, koliko god su precizno | pokušali reproducirati
prirodne Zemljine ekosustave, | pokus se našao u gabuli.
Nakon 1,5 g., morali su dodati | kisik u zatvoreni sustav
jer biljke nisu | dovoljno rasle
i èlanovi posade su | katkad bili gladni.
U drugome pokusu, | NASA-in znanstvenik
na mnogo umjetniji naèin | koristi biljke
za svoj sustav | održanja života.
Bog, Greg. Bog, Dave.
Spreman za žetvu popodne? | Gotovo spreman.
Ovo je komora od 20-ak m2. | Ovdje biljke Davida Bubenheima
rastu 10 do 20 puta gušæe | nego u prirodi.
Umjesto da imitira prave | ekosustave, upravlja biljkama
na sve moguæe naèine | kako bi osigurao
zdravu i postojanu žetvu.
Ljudski životi æe ovisiti | o tome, pa nastojimo
pokazati da tijekom duljega | razdoblja možemo osigurati
svu hranu, sav zrak i svu vodu | koju posada treba
reciklirajuæi pritom | njihove fekalije.
Veliki izazov za zatvoreni | sustav održanja života su
1 do 1,5 kg izmeta | koje èovjek stvori svaki dan.
U Bubenheimovu sustavu biljaka | izmet najprije ide u stroj
koji destilira vodu pomoæu | viška topline iz staklenika.
Voda koja izlazi iz strojeva | nije u potpunosti za piæe.
Svakako je bolja od izmeta | koji je ušao u stroj,
ali još ima nešto amonijaka | i organskih tvari.
To moramo ukloniti | da bi bila prikladna za piæe.
Spomenute kemikalije su | savršena hrana za biljke
pa se gotovo èista voda | vraæa u staklenik.
Biljke koriste vodu za rast | i odaju vodenu paru
koja se kondenzira | u kondenzatorima
na rubovima staklenika. | Voda je zapravo
dvaput destilirana | i prikladna je za piæe.
Dobra je.
Zahvaljujuæi dodatku | umjetnih hranila
i svjetiljkama | visokoga intenziteta,
biljke u Bebenheimovu | stakleniku rastu brzo
i proizvode ogromne kolièine | hrane.
Nakon svake žetve, | stare biljke se zamjenjuju.
Ono što se sada èini rijetkim | bit æe spremno
za ponovnu žetvu | za samo nekoliko dana.
Nakon nekoliko godina, | Bubenheim je uspio uzgojiti
dojmljivu lepezu usjeva.
Rutinski se provjerava | kvaliteta hrane,
a svako malo Bubenheim | i njegovi pomoænici
skuhaju jednostavni objed.
Sada su sigurni da bi njihov | revolucionarni biljni sustav
za održavanje života mogao | raditi punom parom 2005. g.
Zahvaljujuæi iskustvu | s prototipom, toèno znaju
koliki bi sustav mogao | održavati postaju na Marsu.
Ova komora ima 20-ak m2 | i èetveroèlanoj posadi može
osigurati i reciklirati | potreban zrak i vodu,
ali ne može osigurati | svu potrebnu hranu.
To bi mogla sa 4 puta | veæom površinom,
odnosno ovolikom komorom | po osobi.
Bubenheim sada eksperimentira | s bojom svjetlosti,
kako bi smanjio utrošak | energije u sustavu.
U svim scenarijima koje smo | razmotrili sa stajališta
životnoga okoliša u svemiru, | energija je vrlo ogranièena
i ako æemo strujom stvarati | svjetlost, moramo je koristiti
jako uèinkovito. Pogledate li | ove žitarice koje rastu
na bijelomu svjetlu, | kao biljke u prirodi,
gdje su zastupljene sve boje | spektra, vidjet æete dosta
manjih pokrajnjih izdanaka. | Ti izdanci su otpad
koji se mora reciklirati | jer samo više središnje vlati
proizvode žito. | No, ako žitarice rastu
pod plavim svjetlom, | nema pokrajnjih izdanaka
pa središnji nisu zakinuti.
Crveno svjetlo ima | isti uèinak.
Ako boja svjetla može smanjiti | otpad, ne samo u žitaricama,
održavanje života | zasnovano na biljkama
postat æe još privlaènije. | No može li sustav zasnovan
na biljkama biti pouzdan | tijekom cijele misije na Mars?
Barem se jedan astronaut | boji krize
Pojavi li se kakav virus, | bakterija, bolest,
ako biljke iz bilo kojega | razloga obole,
ravnoteža je izgubljena, | a posljedice su pogubne.
Projekti koje izraðujemo | za moguænost stvarne
izgradnje sustava u svemiru | daju moguænost segregacije.
Ako se javi bolest u jednomu | dijelu, lako æemo je izdvojiti
i ogranièiti tako da se | ne proširi na ostale biljke.
Prijam, Mars Explorer 1.
Tijekom tako duge misije, | astronauti æe biti zaposleni
projektima poput staklenika | na letjelici.
Bit æe slobodni izmeðu | pregledavanja plana misije.
Lekcija koju smo nauèili | na Apollu
jest da æe poæi po zlu | sve što može poæi po zlu.
Vozio sam jedini auto u krugu | od 400 milijuna km
i odbio sam blatobran, | što su neki moji prijatelji
vjerojatno i oèekivali. | Od gubitka toga blatobrana
Cernanov rover je dizao | toliko prašine
da je oprema bila ugrožena. | Misija je bila ugrožena
ako ne naprave novi blatobran.
Napravili smo blatobran | od geoloških karata
koje nam nisu baš trebale | tako da smo ih zalijepili
dok su bile èiste | i bez prašine.
Slijepili smo ih 4 i savili | da zamijene blatobran
koji sam odbio s kotaèa | tako da se Mjeseèeva prašina
ne diže u zrak | i ne pada po svemu.
To je bio kritièni, | kljuèni popravak.
Moguænost popravaka u svemiru | je kljuèna,
ali nošenje tona prièuvnih | dijelova nije praktièno.
No kad bi astronauti mogli | doæi do raèunalnoga nacrta
ošteæenoga predmeta, | mogli bi od nule napraviti
plastièni ili metalni | nadomjestak.
NASA trenutaèno radi | na toj tehnologiji,
pa bi trebala biti spremna | do misije na Mars.
Radi postavljanja | prièuvnih dijelova,
NASA koristi | prividnu stvarnost.
U prividnomu svijetu | astronauti mogu vježbati
izvoðenje popravaka tijekom | svemirskom šetnjom
prije stvarne opasnosti.
Brzo uèe raspored ureðaja.
Simuliraju postavljanje | i skidanje vanjskih predmeta.
Razmišljamo o misiji na Mars | za èiji dovršetak bi trebale
2, 3 ili 4 godine. Sva obuka | bi se obavljala na Zemlji,
David Homan | NASA Johnson svemirski centar
2, 3 godine | prije nego što æe vam trebati.
Prividna stvarnost, odnosno | vježbanje u letjelici
omoguæuje osvježenje znanja | od prije nekoliko godina.
Popravci æe biti neizbježni | tijekom misije na Mars.
Zakazivanje opreme je jedan | od mnogih rizika na misiji.
Rizik je i kozmièko zraèenje. | Buduæi da bi štiæenje
cijele letjelice | previše otežalo letjelicu,
posada æe biti izložena | polovici doze
koju pilot putnièkoga aviona | dobije tijekom radnoga staža.
Mikrometeori putuju svemirom | oko 50.000 km/h.
Pogodak jednoga manjega | od gumice za brisanje
mogao bi biti poguban. | A najzloæudnije su
moæne Sunèeve baklje | koje šalju smrtonosne ione
Sunèevim sustavom | bez upozorenja.
Na Zemlji atmosfera sprjeèava | kozmièko zraèenje da prodre,
a svi osim najveæih meteora | izgore.
Èak i smrtonosne ione | Sunèevih baklji
odbija Zemljino | magnetsko polje.
Za putnike izvan Zemljine | orbite nema zaštite.
Kao što se pokazalo na ruskoj | svemirskoj postaji Mir,
najveæi rizik za posadu | tijekom dugoga putovanja
jest bestežinsko stanje. | Naše kosti i mišiæi
onoliko su jaki | koliko moraju biti.
U svemiru, gdje gravitacija | ne optereæuje ljudsko tijelo,
kosti gube kalcij, | a mišiæi snagu.
1995. Sjedinjene Države | poèele su slati astronaute
na Mir da vide kako Rusi | uspijevaju ostati u svemiru
godinu dana, ili dulje.
Astronautkinja Shannon Lucid | srušila je amerièki rekord
od 6 mjeseci.
Astronaut Norman Thagard | proveo je 4 mj. Na Miru,
a Rusi su vjerojatni partneri | u misiji na Mars.
Thagard je prikupio | podrobne podatke
o reakciji njegova tijela | na bestežinsko stanje.
No uglavnom je testirao | ruske metode
borbe protiv uèinaka | bestežinskoga stanja.
Rusi imaju veliko iskustvo | s dugim svemirskim letovima
i znaju da ako ne vježbaju | marljivo na takvim misijama,
neæe biti u dobromu stanju | kad se vrate.
Zato Rusi imaju 2 jednosatne | seanse vježbanja na dan.
Cilj vježbi je podvrgnuti | kosti i mišiæe istim silama
i naprezanjima pod kojima | bi bile na Zemlji,
tako da ostanu prilagoðeni | Zemljinoj gravitaciji.
Ja sam lijeènik pa sam znao | da æu brzo izgubiti kondiciju
ako ne vježbam i zato sam | izuzetno marljivo vježbao
tijekom cijeloga boravka | na postaji Mir.
Kad se Thagard vratio, | svi su željno išèekivali
vidjeti je li se | njegovo vježbanje isplatilo.
Kad smo sletjeli, unutar | 10 minuta od pristajanja
ustao sam, ne baš lako, | ali sam ustao
i ostao sam stajati | dok nisu otvorili vrata
i pustili sve ostale van | prije mene,
da bih zatim bez pomoæi | izašao iz letjelice.
Mnogi se kozmonauti | teško tjeraju na vježbanje,
kao i Vladimir Tetov koji je | proveo 13 mj. Na Miru.
Na moju nesreæu, jako mi je | teško vježbati kad ne želim.
Ako volite vježbanje | i vježbate 3 puta na tjedan,
sve je u redu.
Ali kad morate vježbati | 2 puta na dan, svaki dan,
godinu dana, to se pretvori | u dosadu, muèenje.
Èak i ako kozmonauti | ustrajno vježbaju,
neki se ne mogu nositi | s gravitacijom
nakon 6 ili više | mjeseci u svemiru.
Problem održavanja kondicije | do dolaska posade na Mars
vjerojatno je veæi od onoga | u orbiti oko Zemlje
jer kad se vratite iz orbite, | ako bude potrebno,
netko æe vas odnijeti | iz letjelice.
Ali kad posada ide na Mars | i stigne onamo,
mora biti u dovoljno dobromu | stanju da svojski radi.
Rotiranje letjelice da bi se | proizvela umjetna gravitacija
dugo se smatrala idealnim | rješenjem problema vježbanja.
Princip umjetne gravitacije | svima je poznat.
Kad kružite petljom | tobogana straha,
stvara se centrifugalna sila | koja vas drži za traènice.
Rotirajuæa letjelica isto bi | stvarala centrifugalnu silu
i prikovala astronaute za pod | oponašajuæi gravitaciju.
Kao student inženjer | na Sveuèilištu Stanford,
John Wilson je isprobao | jedan od najperspektivnijih
i najisplativijih naèina | stvaranja umjetne gravitacije.
Dvama vezanima lebdjelicama | na zraèni pogon,
Wilson je demonstrirao | rotaciju oko središnje toèke
kakvu bi vršio svemirski brod.
Mali potisnici na oba stroja | opale u pravomu trenutku
kako bi održali | postojanost sustava.
Koncept je uspješan, ali | u svemiru je sve složenije.
Pokus pokriva promjer | od samo metar i pol,
a u svemiru bi to isto | bilo jako veliko,
možda 800 m u promjeru.
Ne znamo koliko bi nam trebalo | da izgradimo i isprobamo
svemirsku letjelicu | s umjetnom gravitacijom.
Znanstvenici u NASA-inomu | Istraživaèkomu centru Ames
istražuju novi naèin umjetnoga | stvaranja gravitacije.
U ovoj sobi koja bi stala | u šatl,
nalazi se bicikl-centrifuga, | novi stroj za vježbanje
koji koristi snagu pedaliranja | dvoje ljudi
da bi jednoga od njih vrtio | velikom brzinom. Spreman.
Astronauti imaju | pošteni aerobni trening,
a izmjenjujuæi se | na centrifugi
takoðer dobiju veliku dozu | umjetne gravitacije.
Èak i ako se osobi koja se | vrti zavrti i ne pedalira,
centrifugalna sila æe je | nastaviti tlaèiti o podlogu
pa æe kosti i mišiæi biti | pod naprezanjem
koje im je potrebno | da bi održali formu.
Najperspektivniju tehnologiju | za borbu sa štetnim uèincima
bestežinskoga stanja | NASA je upravo testirala
u pokusu ležanja u krevetu. | Dobrovoljci su morali ležati
tako da im vise glave, | što je položaj
koji astronautima stvara | probleme dok nema gravitacije.
Stvori se mala bol u križima, | dobijete glavobolju.
Možda mi se katkad malo vrti | u glavi od ovoga položaja,
Brent Walker | Dobrovoljac u istraživanju
nije baš lako. | Tekuæina se slije u glavu
Glenn Stover | Dobrovoljac u istraživanju
i nabreknu mi oèi | te mi se zaèepi nos.
Mišiæi poènu atrofirati
Alan Hargens | Psiholog, NASA Ames
i to se nastavi, a s vremenom | vam se smanjuju i kosti.
Ova ispitivanja nisu šala | za one koji ih prolaze.
Što se tu skriva? | Najprije je dobro,
ali gutanje postaje sve teže.
Svrha tih neugodnosti | je ispitivanje nove,
napredne trake za trèanje | za svemirsku uporabu.
Problem s današnjim trakama | je uporaba elastiènih traka
za stvaranje sile, a elastika | jaèe radi što je nategnutija.
Ako je elastika dovoljno jaka | da astronaut osjeti
svoju normalnu težinu | kad trèi,
znaèi da æe biti prenategnuta | da se odigne i trèi.
Dakle, da bi bile uporabljive, | elastiène trake moraju biti
slabe i proizvoditi umjerenu | silu koja ima slabi uèinak
na održavanje kostiju | i mišiæa.
Novi stroj koristi | vakuumsku pumpu
koja uvlaèi èovjeka | u stroj za trèanje,
i postiže mnogo veæu silu.
Kako bi oponašao | vježbanje u svemiru,
Brent Walker je morao trèati | u ležeæemu položaju
tako da Zemljina gravitacija | ne utjeèe na rezultate.
Brente, ukljuèit æemo stroj. | U redu.
Možeš se podiæi.
Vakuum je ukljuèen. Pojaèat æu | na punu tjelesnu težinu.
Kako je vakuum isisao | zrak iz komore,
Brentova stopala | su uvuèena u stroj.
Ležeæi, a osjeæajuæi se | kako stoji okomito
i nosi svoju normalnu težinu, | èudno se osjeæao.
Naviknete se i nekad imate | osjeæaj da letite bez napora.
To je vrlo èudan osjeæaj.
Svejedno se znojite.
Buduæi da je stroj pokusni, | Brent mora ocijeniti napor.
Reci, Brente, stupanj | izmorenosti?
13. 13? Dobro.
170 otkucaja srca u minuti.
Osjeæati normalnu težinu | dok vježbate u svemiru
dvostruko je bolje | od elastiènih traka,
ali od ovoga stroja se možete | osjeæati i mnogo težim.
Poveæavam tlak | na 1,2 tjelesne težine.
Kako raste vakuum, | raste i naprezanje
u Brentovim | kostima i mišiæima.
Kao da imam ruksak. | Oko 15 kg, otprilike.
Puno je teže. Definitivno, | teško mi je za pluæa
i za mišiæe. Puno teže.
Pitanje je može li 40 minuta | na dan u vakuumskomu stroju
sprijeèiti gubitak | koštanoga i mišiænoga tkiva.
Osjeæam da su mi mišiæi | puno jaèi.
Ojaèali su otkad sam | poèeo ovako trèati.
Mislim da æe mi pomoæi.
Doista je teško procijeniti | dok god ne ustanem.
Nakon 2 tjedna sudjelovanja | u ležaèkomu istraživanju,
došao je trenutak istine.
Priprema, pozor, sad!
Brent je trèao brže | nego prije istraživanja.
Priprema, pozor, sad!
Ali oni koji nisu koristili | vakuumski stroj,
npr. Bill Davis, bili su | puno sporiji nego prije.
Osjeæam se nekako slabo, | nemam ni energije ni snage.
Neka ti peta bude ovdje.
Idemo. Guraj. Guraj, guraj, | guraj. Dobro, opusti.
Još. Guraj, guraj, guraj. | Opusti. Guraj.
Guraj, guraj, guraj. Opusti. | Guraj.
Oni koji su, poput Brenta, | vježbali, zadržali su stanje
ili su ojaèali. Jasan dokaz | da vakuumski stroj radi.
Gubitak kosti je mjerio stroj | koji vibrira uz nogu
da bi procijenio | krutost kosti.
Osjeæat æeš težinu. | Je li neudobno?
Malo, ali nije strašno.
Rezultati nisu bili tako jasni | kao oni za mišiæe,
ali èini se da govore | da vakuumski stroj
može pomoæi astronautima | u misiji na Mars.
Ako je ovo pokazatelj, bilo bi | im, naravno, puno bolje
sa strojem, nego bez njega. | Ovo je sigurno dobar korak
u održanju kondicije ljudi | u svemiru.
Mars Explorer 1, prijam.
Misiji na Mars bi trebalo | oko 102 dana da doðe
na pola puta | do crvenoga planeta.
Svako jutro poèinje rutinskim | jednosatnim vježbanjem,
ukljuèujuæi | u vakuumskomu stroju.
Astronauti znaju kako važno | æe biti da su u kondiciji
kad slete na Mars i opet se | susretnu s gravitacijom.
Posada æe redovito vježbati | da joj ne bude dosadno
tijekom ovoga dijela misije. | Bit æu sprijeda.
Dobro, doæi æu po tebe | ako mi zatrebaš.
No bit æe i trenutaka kad | se neæe misliti na vježbanje.
Alarmi æe se oglasiti ako | nevidljivi smrtonosni ioni
Sunèevih baklji | prodru u letjelicu.
Svaka sekunda izloženosti može | poveæati ošteæenje tkiva,
pa se posada brzo povlaèi | u jedini zaštiæeni prostor.
U dva m2 skloništa | u sluèaju nužde
nalazi se hrana i pristup | vitalnim sustavima letjelice.
Sunèeve baklje bi mogle | trajati nekoliko sati,
ili tjedan dana, | ili èak dulje.
Svemirska putovanja su uvijek | opasna i nepredvidljiva.
Dok smrtonosne Sunèeve baklje | bombardiraju svemirski brod
s posadom na putu za Mars, | astronauti moraju ostati
u skloništu | koliko god je potrebno.
U malomu skloništu | za sluèaj nužde,
mogli bi se umoriti i od | skuèenosti i jedni od drugih.
Njihova æe izdržljivost biti | na velikoj kušnji.
Nova podruèja, poput Marsa, | neophodna su ljudima
jer im daju i slobodu | i izazov.
Neosvojeno podruèje, | poput amerièkoga Zapada,
Bob Zubrin | Pioneer Astronautics
stavlja ljude u nove situacije | u kojima mogu biti inovativni
i moraju biti inovativni jer | stare navike nemaju smisla.
Moraju odbaciti nepotrebno, | skinuti suvišno sa sebe,
stvoriti nešto novo. | I upravo tada ljudi
pokazuju najbolje što imaju. | Tada, pred najveæim izazovom.
Danas na Zemlji živi | 6 milijardi ljudi.
Daniel Goldin | Administator u NASA-i
Kad sam se rodio, bile su | 2 milijarde na Zemlji.
Za manje od 3 naraštaja, | broj ljudi se utrostruèio.
U iduæa æe se 2 naraštaja | udvostruèiti.
Bit æe 12 milijarda ljudi. | Njima æe trebati resursi.
To je jedan od glavnih razloga | zanimanja za Mars.
Apollo nas je nauèio da æe | misija na Mars s posadom
biti najteži psihièki izazov | u povijesti èovjeèanstva.
Na Apollu 17 astronaut | Gene Cernin je razmišljao
o rizicima koji su ga pratili | tijekom cijele misije.
Pripremi se za dodir s tlom. | Pozor, 8 metara, spuštamo se,
mali udar, èini se dobro. | Uzbuðenje je veliko
i mnogo toga se dogaða | tijekom slijetanja.
Mnogo buke, znate, prašine | i dogaðaja.
3 metra. Kontakt. | Gotovo, stali smo.
Odjednom ste dodirnuli tlo | i ugasili motore.
To je možda najtiši trenutak | u životu bilo kojega èovjeka,
jer sve prestane. | Nema prašine, nema buke,
nema kretanja, samo sjedite | i slušate hoæe li zapištati
neki probušeni spremnik, | ili takvo što.
Nalazite se usred | velièanstvene osame.
Ako padnete i zaparate odijelo, | u nevolji ste.
A tada uðete u auto, | elektrièni auto
i udaljite se od svojega | doma na Mjesecu.
Udaljite se toliko | da vas ne mogu vidjeti.
Prijeðete preko brijega | i skrenete za ugao.
Ako vam se pokvari auto, | eto, imali smo pravila.
Ne smijete otiæi dalje | nego što možete prehodati.
Tri, dva, jedan, polijetanje. | Houston, krenuli smo.
Što bi se dogodilo | da nismo krenuli?
Ne samo da smo morali | upaliti motore da napustimo
površinu, nego su morali | biti upaljeni
toèno odreðeno vrijeme, | inaèe ne bismo ušli u orbitu.
Lagano bismo se sudarili | s Mjeseèevom površinom.
Prihvatili smo te rizike. | Izazove, prilike,
možda netko to ne bi uèinio. | Ali vjerujem da bi veæina,
da dobije priliku, prihvatila | razinu rizika
koju smo mi prihvatili | da bismo išli na Mjesec.
Biti dijelom nastojanja | da se zakoraèi
Tom Jones | Astronaut
i trajno prisutni | na stranomu svijetu,
za to bih mnogo žrtvovao.
Dakle, ukljuèeni rizici, | odvagnuti, izmjereni
i ukljuèeni u planove, | bi bili prihvatljivi,
kao što su rizici putovanja | svemirom u šatlu.
Rizici koje su istraživaèi | prihvaæali tijekom povijesti
ljudskoga istraživanja Zemlje | istovjetni su rizici,
èak i veæi u prijašnjim | stoljeæima,
nego u sluèaju misije na Mars.
Svakako, voljela bih
Shannon Lucid | Astronautkinja
da razlièiti svemirski | programi suraðuju
s ciljem odlaska na Mars, | jer mislim da bi to bilo
jednostavno izvrsno | za sve nacije na Zemlji,
ta suradnja sa zajednièkim | ciljem odlaska na Mars.
Mislim da bi to bilo | genijalno i voljela bih
da se to dogodi | za mojega života.
Ruska svemirska postaja Mir | drži rekord
u duljini svemirskih letova.
Danas kozmonauti znaju | provesti 14 mjeseci u svemiru.
Dvostruko dulje | od putovanja na Mars
i gotovo pola trajanja | cijele misije.
Dugaèke misije se mogu | olakšati blagodatima doma.
Na Miru je èak parna kupelj, | tradicionalna ruska banja,
ukljuèujuæi grane breze. | Ali kozmonauti su shvatili
da se katkad stvari | znaju zakomplicirati,
kao na primjeru Vladimira | Titova i Muse Miranova
za vrijeme njihove | trinaesteromjeseène misije.
2 mj. Nakon polijetanja, | zakazala je orijentacija.
Vladimir Titov | Kozmonaut
Svemirska postaja nije više | bila postavljena prema Suncu.
Odjednom više nismo mogli | puniti solarne akumulatore
i gubili smo energiju.
To je bilo zastrašujuæe, | morali smo ugasiti svjetla.
Ventilatori nisu radili, | bilo je malo struje.
Dugo smo se pokušavali izvuæi | iz toga, oko tri tjedna.
Morali smo popraviti | sve ureðaje koji su zakazali.
Iako su mogli kapsulom | za spašavanje otiæi na Zemlju,
a to ne bi mogli s Marsa, | razriješili su situaciju.
Ali onda je došao | novi problem.
To su bili trenuci kad smo | dosadili jedan drugome.
Uglavnom je to bila posljedica | psihièkoga stresa.
Nikad se zapravo | nismo svaðali.
Otišli bismo do prozora | i promatrali Zemlju.
Bili smo sami | kad nam je bilo dosadno.
Sreæom, kad god smo obavljali | važne zadatke zajedno,
svi problemi | izmeðu nas bi nestali.
Kako odabrati posadu za prvu | ljudsku misiju na Mars?
Nekoga tko se može nositi | i s rizicima i sa stresom.
Odgovor se možda nalazi | iza ovih vrata
u ruskomu centru | za obuku kozmonauta,
Zvjezdanomu gradu. | U Sjedinjenim Državama
psihološki èimbenici | igraju malu ulogu
u odabiru putnika u svemir. | U Rusiji je psihologija sržna.
Na svakoj kritiènoj etapi | obuke kozmonauta,
netko, poput psihijatra | Olega Ryumina, promatra.
Danas je Oleg Kutov | prvi put u centrifugi
da se vidi podnosi li | gravitacijsku silu lansiranja.
Kako bi se ispitala | njegova sposobnost
koncentracije pod pritiskom, | mora pritisnuti gumb
kad god se ove žarulje upale.
Olega æe tlaèiti gotovo | 7-struka gravitacijska sila.
U kontrolnoj sobi je | psihijatar Oleg Ryumin.
Promatram njegov izraz lica | i reakcije.
Promatram gleda li samo jednu | toèku ili prostor oko sebe.
Ispit traje samo 5 minuta. | S fizièkoga stajališta,
Oleg je prošao. | A sa psihološkoga?
Malo nervozan, ali ovo je bila | prva rotacija u centrifugi
ovoga mladoga kozmonauta. | Dobra je osoba. Sviða mi se.
Nakon krize | sa solarnim bakljama,
posada opet ima pristup | cijeloj letjelici.
Osnovno je utvrditi jesu li | elektronièki sustavi
ošteæeni zraèenjem. | Iako bi šteta na letjelici
mogla biti minimalna, | planeri misije pretpostavljaju
da bi stres astronauta | mogao biti golem.
Zato su smislili naèin | da smanje napetost
porukama od voljenih.
Buduæi da na letjelici | neæe biti mnogo mjesta
za znanstvenu opremu | ili pokuse
koji nisu usko vezani za Mars, | bit æe teško
boriti se protiv dosade.
Astronauti bi mogli provesti | sate gledajuæi kroz teleskop.
Ili bi mogli vježbati. | Ali svi æe misliti o onome
što ih èeka kad napokon slete | na crveni planet.
Jedan od najvažnijih | ruskih psiholoških ispita
za odabir kozmonauta | obavlja se u ovoj sobi.
Zvana 'deserta kamara', | ili tiha komora,
to je soba u kojoj | potencijalni kozmonauti
moraju provesti 10 dana | u osami,
prva tri dana bez spavanja.
Kako bi se simulirao | stres prave misije,
sva komunikacija s kozmonautom | dogaða se putem nekoliko
obojenih žaruljica.
Prvi ispit je brojanje. | Ali, postoji kvaka.
Brojevi su pomiješani, | a kandidat mora brojati
crne naprijed, | a crvene unatrag.
Što manje ima pogrešaka | i što brže broji,
to mu je bolji rezultat.
No kako bi stvari bile | još složenije,
istovremeno se s vrpce èuje | drugi glas kako broji.
A sada, drugi test. | Pogledajte.
Možete li zapamtiti | ove znakove?
Kandidat za kozmonauta | može ih promatrati samo 2 s,
a onda ih mora zapisati | po sjeæanju.
Stres se nagomilava. | Kad postane pospan,
mora vježbati. | Za cijeloga ispita,
ova ladica mu je jedini | kontakt s vanjskim svijetom.
Jede istu hranu kakvu | kozmonauti jedu u svemiru.
Kako vrijeme prolazi, | pritisak se poveæava,
kao za kozmonauta | na zakompliciranoj misiji.
Svakih nekoliko sati mora | složiti niz obojanih kartica.
Ruska psihološka teorija kaže
da redoslijed kartica odražava | stanje njegova uma.
Kako postaje umoran, | bori se sa snom,
a naredbe i dalje pristižu.
Sve sporije obavlja zadatke, | ali brzina više nije kljuèna.
Svi se umore, | ali neki prestanu raditi.
Èak se ne bore, | jednostavno odustanu.
Neki nastave raditi, | ali èine previše pogrešaka.
Još jedna loša reakcija | na nedostatak sna
jest haluciniranje.
Ako netko halucinira | za vrijeme ispita,
to je jasan znak da ne bi | trebao postati kozmonautom.
Nakon 3 dana nespavanja | i još 7 s malo spavanja,
muèenje je gotovo. S obzirom | na duljinu misije na Mars,
testovi na stres kljuèni su | pri odabiru astronauta.
Ovdje, u Zvjezdanomu gradu, | psiholozi imaju i test
kojim predviðaju kako æe se | kozmonauti meðusobno slagati.
Zove se homeostat, | a zaèudo je nadahnut
zajednièkim tuševima | u kojima su se kozmonauti
nekoæ tuširali nakon obuke. | Psiholozi su
promatrajuæi kozmonaute, | èesto slušali pritužbe
na temperaturu vode, ali samo | dok su se neke grupe tuširale.
Problem je bio u tome što bi, | kad bi si jedna osoba
povisila temperaturu vode, | ostali imali hladniju vodu.
Psiholozi su zakljuèili da su, | ako skupina kozmonauta uspije
sama razriješiti problem | prilagodbom tuševa,
u toj skupini vjerojatno | kompatibilni kozmonauti.
Taj koncept stoji iza | homeostatskoga testa,
ali umjesto vode se koristi | elektronièka kutija
s kotaèiæem i skalom.
Dobiti nulu na skali | istovjetno je toplomu tušu.
A èak i ako ne pomièete | svoju iglu,
ona se mièe kad vaši kolege | usklaðuju svoje.
Najprije su svi poèeli | jako okretati kotaèiæe
kako bi dobili osjeæaj | za ureðaj.
Psiholozi su gledali dramu | na velikomu ekranu.
Uskoro je Oleg odluèio | prestati pomicati kotaèiæ
i pustiti Tanju i Valerija | da sami riješe problem.
Puno je lakše dobiti nulu | ako samo dvoje pokušavaju.
Kad su Tanja i Valerij | dobili nule,
Oleg je poèeo blago | pomicati kotaèiæ
tako da se ostali mogu | prilagoðavati
i na kraju su svi bili | na nuli.
Homeostatski test kaže da bi | dobro suraðivali u svemiru.
Mnogo toga s Mira što posada | cijeni na dugotrajnim misijama
neæe biti dostupno | na misiji na Mars.
Udaljenost æe onemoguæiti | simultane video konferencije
sa Zemljom koje su | kozmonautima dostupne
bar jednom ili dvaput | na tjedan.
Prozori koji omoguæuju posadi | da promatra Zemlju
kad god su nostalgièni, | bit æe beskorisni.
Svi koji lete svemirom | gledaju kroz prozor,
Norman Thaggard | Astronaut
i èine to kad god stignu.
Prizor je fantastièan.
To ne možete susresti | nigdje drugdje.
Ako zbog neèega | ne možete spavati,
Sergei Krikalev | Kozmonaut
možete jednostavno | otiæi do prozora
i uživati u prizoru Zemlje | jako dugo.
Na putu na Mars | neæemo to moæi èiniti.
Oleg Ryumin | Ruski psiholog
Put na Mars æe biti | zamrznuta slika
nepomiènih zvijezda i Zemlje | kao toèkice meðu njima.
Novi raèunalni sustav | koji je razvila NASA
mogao bi olakšati situaciju | i omoguæiti putnicima na Mars
da sa sobom ponesu | komadiæ doma.
Ovdje Dan i ja peremo psa | i zabavljamo se.
Sve nas je poprskao pjenom.
Ideja je razvijena | radi amerièkih astronauta
smještenih na Miru, | ali mogla bi se primijeniti
i na putovanje na Mars.
Prije nego što | astronaut napusti Zemlju,
njegova obitelj i prijatelji | snime slike, zvukove, poruke.
Zdravo.
Ptièica.
Bog, tata. Baš je fora | da si u svemiru.
To mi je super, | ali jedva èekam da se vratiš.
U NASA-i æe ih pohraniti | u raèunalo
tako da ih obitelj može | editirati kako god želi.
Na kraju æe nastati | raèunalni fotoalbum
koji astronaut može | listati po volji.
I da se prekine | svaka veza s domom,
astronautu bi ostalo barem to.
U idealnom sluèaju bi obitelj | stavljala nove video snimke
i nove fotografije | jednom na mjesec
Al Holland | Psiholog u NASA-i
i slala ih u letjelicu | jednom na mjesec,
za putovanja na Mars | ili povratka na Zemlju.
No, buduæi da tehnologija veze | nije uvijek potpuno pouzdana
prije lansiranja, želimo imati | bar jednu snimku
ili fotografiju iznenaðenja | za svaki dan misije
koju bi astronauti | imali sa sobom.
Kontrola, ovdje Mars Explorer | Jedan. Nadam se da nas èujete.
I nakon 192 dana u svemiru, | posada bi još uvijek mogla
komunicirati sa svojim | obiteljima.
Mama ti je juèer bila | na pregledu
i tlak joj je u redu. | Prestani se brinuti.
Ali kašnjenje bi bilo | frustrirajuæe.
Astronauti bi plutali mraènim | svemirom skoro pola godine.
Sad æu stati jer znam da ovo | neæeš dobiti još 20 minuta,
a onda još moram èekati | tvoju poruku.
Idem neko vrijeme | raditi u vrtu.
Sad su veæ dovoljno blizu | Marsa da vide neke detalje.
Za 10 dana æe moæi | zakoraèiti crvenim planetom.
Nova raketa, u razvoju | u Svemirskomu centru Johnson,
mogla bi skratiti samoæu | dugih svemirskih putovanja.
To je ideja izumitelja | i šatl-astronauta,
veterana | Franklina Chang-Diaza.
Astronaut koji je | letio svemirom
postane svjestan usamljenosti | koja ondje vlada.
I toga da u konvencionalnoj | misiji na Mars
veæinu vremena provedete | gledajuæi kroz prozor,
a da nemate što vidjeti. | Tijelo propada
i pod velikim je utjecajem | nulte gravitacije.
Dakle, cilj je | skratiti to putovanje.
To nam je vrlo uzbudljivo | jer po prvi put doista možemo
složiti misiju na Mars | koja traje do 3 mjeseca.
Umjesto da plin gori, | ova raketa pomoæu struje
pretvara plin u visoko | energetsko stanje, plazmu,
koja se zatim ogromnom brzinom | istiskuje iz motora.
Neæe jaèe gurati letjelicu, | ali æe trošiti manje goriva
pa æe moæi raditi dulje | od konvencionalne rakete
i postupno postiæi | veæu brzinu.
Spremni za podešavanje | napona, korak 3.
Konvencionalna raketa u biti | ima jednokratni potisak,
motor radi odjednom | dok se gorivo ne potroši.
Raketa zapravo predstavlja | veæinu cijene misije na Mars.
Na mikrovalnomu su | dva crvena pokazivaèa.
Možemo poveæati brzinu rakete | 5 ili 7 puta
zato što stalno ubrzavamo.
Zapravo, dok putujemo na Mars, | raketa radi cijelo vrijeme.
Korak broj 10, Laura.
Vodeni ventil zraènoga | izmjenjivaèa topline.
Letjelica na Mars | s raketom na plazmu
trebat æe tri mala nuklearna | elektrièna generatora
za stvaranje plazme. | Ironièno, u '60-tima je NASA
razvila raketu koja je rabila | nuklearnu energiju, Nervu.
Isto nije sagorijevala plin, | nego ga je zagrijavala
do vrlo visokih temperatura | u nuklearnomu reaktoru.
Nizom testova pokazalo se | da je uèinkovita i lagana.
Ali se ipak odustalo od nje
jer se javnost brinula | u vezi s nuklearnom energijom.
NASA-ina plazmena raketa | ne bi bila moguæa
bez struje nuklearne | proizvodnje.
Dakle, ako želimo | brzo na Mars,
treba nam | nuklearna energija.
Gumb za paljenje. Tako. | Dobro.
Današnji test | ne koristi punu snagu
za provjeru svih komponenata.
Dobro. To je gotovo to. | Bit æemo spremni, ne?
Gwen, kreni. To je to.
To je to. Da.
Vidi se, vidi se izboj. | Imamo izboj. Da.
Ljubièasti sjaj plazme ulijeva | u Chang-Diaza sigurnost
da æe njegova raketa biti | spremna za Mars 2005.
Lekcije s ruske svemirske | postaje Mir mogle bi biti
korisne za misiju na Mars. | Èetveromjeseèni boravak
amerièkoga astronauta | Normana Thaggarda na Miru
pokazala su da razlike | u jeziku i kulturi mogu biti
mali, ali iritirajuæi problem.
Tada sam veæ bio prošao | nekoliko godina uèenja
ruskoga jezika i razumio sam | skoro sve što su govorili.
Mislim da sam imao više | problema kad sam se htio
precizno izraziti, pa nisam | pokušavao prièati viceve.
Uvijek sam raèunao s tim | da ako isprièam vic,
mogu zapravo reæi nešto | što nisam htio reæi.
Genadij je, s druge strane, | stalno bio pun viceva
na ruskom i nisam | razumio mnogo njih.
Kad smo saznali da je umrla | majka zapovjednika Belogije.
Nisam znao kako se Rusi | ponašaju prema prijatelju
kojemu se dogodilo | takvo što.
Morao sam promatrati Genadija, | njegovo ponašanje
prema Belogiji, | i imitirati Genadija.
Kako bi riješila problem, | NASA ima satove
kulturološke obuke | da pripremi astronaute
i pomoæno osoblje za novo doba | svemirskih misija.
Sergej Nikolajeviè Dimonov. | Walter Barnett. Kako ste?
Jedna od metoda | je igranje uloga.
Dakle, inženjer ste u NASA-i.
Ovo je lekcija o sukobu ideja | o osobnom i intimnom prostoru.
Pogledajte sliku | moje žene Saše.
I sina Jurija. Dobro.
A ovo mi je kæi Marina. | Gdje živite, Walteru?
Zapravo živim baš ovdje | u NASA Bayu.
Koliko zaraðujete u NASA-i? | Koliko novca, za koju plaæu?
Mislim da, mislim da dovoljno, | ali radije ne bih...
To je nešto o èemu doista | ne želim razgovarati.
Nadamo se da æe ljudi postati | svjesni obièaja i oèekivanja
drugih pa æe se zaobiæi | kulturološki sukobi.
Dobro te je vidjeti. | Dobro izgledaš.
Dobro izgledaš. Hvala. | I ti dobro izgledaš.
Dobro je vratiti se | u Sjedinjene Države.
Nakon oko 202 dana, | letjelica æe doæi do Marsa
i gravitacija æe je | uvuæi u orbitu.
Kapetan æe poèeti posljednju | seansu prividne stvarnosti
kako bi se pripremio | za slijetanje.
Vježbao je cijelim putem | kako bi se pobrinuo
da slijetanje na Mars | proðe glatko.
Površina Marsa mora se | pomno pratiti zbog snažnih
pješèanih oluja koje se znaju | pojaviti bez najave.
Takva oluja je uništila | rusku letjelicu bez posade
koja je sletjela na Mars | '70-tih.
Iz orbite posada takoðer može | vidjeti mjesta istraživanja.
Mjesta gdje su prijašnje | misije s robotima
otkrile minerale koji mogu | voditi do nalaza života
na Marsu i kljuènih podzemnih | vodenih masa.
Na Marsu ima vode.
Bob Zubrin | Pioneer Astronautics
Oceani vode su smrznuti | u Marsovom permafrostu.
Kad bi površina bila ravna, | a voda se otopila iz tla,
Mars bi bio pod 200 m vode. | To je suho u odnosu na Zemlju.
Na Zemlji bi bila 2 km vode | da je se zaravni.
Ali Zemlja je vodeni svijet. | Da se riješite njezinih oceana
i zamrznete ostatak vode | u tlo, bila bi suha kao Mars.
Samo je 36 h | do spuštanja na Mars
i posada vježba | jaèe nego ikad.
Nakon 6 mjeseci | bez gravitacije,
uskoro æe se opet morati | nositi s gravitacijom.
Kretanje po površini | u svemirskomu odijelu
neæe biti lako. Nisam mislio | da æe biti ovako teško.
Jedna od najbitnijih | tehnologija koje nedostaju
za misiju na Mars je praktièno | svemirsko odijelo.
Apollova Mjeseèeva odijela | bila su tek nešto više
od krutih tlaènih vreæa | za održanje života,
u kojima je bilo | èudno kretati se.
Svemirsko odijelo Mark 3, | projektirano i proizvedeno
u Svemirskomu centru Johnson | u Houstonu, mnogo je bolje.
Raðeno je za rad | u uvjetima bez gravitacije
na svemirskoj postaji pa je | vjerojatno preteško za Mars.
Ali pokazuje kako stavljanje | desetaka nepropusnih zglobova
po odijelu omoguæuje savijanje | i prirodno kretanje,
a ujedno pruža zaštitu | tlaènoga oklopa.
Prvi koraci u stvaranju | odijela za Mars poduzeti su
u ovomu bazenu u NASA-inomu | Istraživaèkomu centru Ames.
Buduæi da ljudi prirodno | plutaju u vodi,
radi simulacije | Marsove gravitacije,
ispitanici nose utege | rasporeðene po tijelu.
Jesi spreman za izlazak | na Mars?
Marsova gravitacija iznosi | 39%% Zemljine
tako da osoba teška 75 kg | na Marsu teži oko 30 kg.
Takoðer sporije pada kad | skaèe, ali ne ovako sporo.
Dodaj još 4 sprijeda | i 2 straga...
Bruce Webben je ravnatelj | programa svemirskoga odijela
i ustanovio je da njegov | ispitanik Eric treba još utega
kako bi se osjeæao teškim | kao na Marsu.
Dobro, ukljuèeno je. | Motor radi.
Dio onoga što Bruce Webben | ispituje je koliko se savijaju
zglobovi kad netko hoda | pri Marsovoj gravitaciji.
Tako æe odrediti koliko | fleksibilno mora biti
Marsovo odijelo, kako bi | omoguæilo prirodne pokrete.
Idemo 1,6 km/h. Ubrzat æemo | na 4,8 km/h. Dobro? Idemo.
Webben želi znati i koliko | manje energije iziskuje
hodanje na Marsu u odnosu | na Zemljinu gravitaciju.
Kako smanjujete gravitaciju, | logièno je da æe kretanje
iziskivati manje napora. | Ali ako uklonite gravitaciju,
ne možete hodati. | Kretanje je posve drukèije.
Pravo pitanje je | što se dogaða na pola puta.
Moramo shvatiti kakav napor | iziskuje kretanje
i hodanje Marsom. | Dok ispitanik vježba,
Webben mjeri koliko | ugljiènoga dioksida proizvodi,
što je jedan od naèina | mjerenja utroška energije.
Tako æe odrediti koliki | spremnik zraka je potreban
astronautima | za dan posla na Marsu
i kakvo im hlaðenje treba | da se ne pregriju.
Ako se ne obave | ovakva istraživanja,
vjerojatno biste, kao | inženjer, predimenzionirali.
Uvijek biste projektirali | sustav da bude siguran,
ali bio bi mnogo veæi, | sustav za održanje života
bio bi mnogo veæi | nego što je potrebno
i odijelo ne bi uopæe | bilo optimizirano.
Kako bi usavršio dizajn | Marsovoga svemirskoga odijela,
Webben stavlja utege | na razlièita mjesta
na okviru za ruksak. | Tako æe lakše utvrditi
gdje bi trebalo biti težište | sustava za održanje života
i gdje bi astronauti trebali | nositi stvari,
npr. Oruðe i geološke | uzorke s terena.
Kad god pomakne teret, | Webben mjeri kako to utjeèe
na ispitanikovu ravnotežu, | udobnost i utrošak energije.
Na kraju æemo otkriti | kako rasporediti težinu
sustava za održanje života. | Možda to neæe biti ruksak.
Možda je uèinkovitije | da su njegovi dijelovi
rasporeðeni oko tijela, | neki sprijeda, neki straga.
Webben kaže da bi mogao | izgraditi idealno odijelo
za Mars u iduæih 3, 4 godine, | ali taj je projekt
NASA stavila na èekanje.
Posada se mora spustiti | blizu letjelice za povratak
koja je došla na Mars | prije 2 godine.
Do sada je trebala stvoriti | gorivo potrebno za povratak.
Osposobi motore. | Osposobljeni.
Pali.
Potisnici okreæu letjelicu | u položaj za slijetanje.
Ulazimo u atmosferu.
Gravitacija? 0,75 G.
Brzina? 2000 m/s. 1700 m/s.
1.9 G. 1300 m/s.
Brzina æe se brzo spuštati, | a gravitacija penjati
dok æe ogromna zraèna koènica | stvarati trenje s atmosferom.
600 m/s. Imamo signal | s letjelice za povratak.
1,9 G. Imamo metu.
Spremni za otvaranje glavnoga | padobrana. 5, 4, 3, 2, 1.
Ukljuèi motore za spuštanje.
70 m. 30 m. 15 m.
8 m. 3 m. Spustili smo se.
Kontrola, | Explorer 1 je sletio.
Dugo smo sanjali | o slijetanju na Mars.
Ovo je najveæi dan | mojega života.
Televizijske slike æe doæi | do Zemlje za 20 minuta.
Doista je èudno hodati, | zar ne?
Krajolik je slièan | onome kod kuæe.
Brežuljci isprani vodom govore | da Mars ima zanimljivu prièu.
Prije gotovo 4 milijarde g., | Mars i Zemlja bili su blizanci
po vlažnosti i toplini. | No iz nepoznatih razloga
Mars je ubrzo postao | hladan i suh.
Posada Explorera 1 sletjet æe | u jednoj od velikih
rijeènih dolina u kojima je | vode bilo u izobilju
tijekom toplijih | Marsovih vremena.
Misija s posadom æe | pokušati saznati
je li se život ukorijenio | na Marsu
prije nego što su uvjeti | postali ovako ekstremni
i postoji li još uvijek | život ispod površine.
Ali osnovni prioritet posade | bit æe da potvrdi
da je letjelica za povratak, | koja je proizvela gorivo
iz Marsove atmosfere, | spremna za povratak.
Postavit æe i nekoliko | postaja za praæenje vremena
kako ih ne bi iznenadila | marsovska oluja,
kad vjetar puše do 130 km/h.
Tek tada æe astronauti bušiti | smrznuto dno negdašnjega
rijeènoga korita | u potrazi za mineralima,
vodom i tragovima života.
Moguænost pronalaska | nekoga prastaroga oblika
fosiliziranoga života, | anaerobnoga života,
organizama koji ne ovise | o kisiku,
koji žive u tlu, | bila bi nevjerojatna.
Na ovome planetu | smo svi znali podiæi pogled
Daniel Goldin | Administrator u NASA-i
i pitati se jesmo li sami, | jesmo li jedinstveni.
Je li svaki oblik života, | složen ili jednostavan,
zasnovan na ugljiku ili ne, | jedinstven za Zemlju?
Jedno od najboljih mjesta | za potragu za tragovima
prošloga života su stari | Marsovi vruæi izvori.
Na Zemlji, u mjestima poput | nac. Parka Yellowstone,
vruæi izvori su puni malih | jednostaniènih organizama.
Dokazi govore da je život | na Zemlji stvoren
u takvomu toplomu | i vlažnomu okruženju.
Slike koje je poslao Viking | otkrile su da je Mars imao
mnogo vruæih izvora | prije milijarda godina,
kad je planet bio | vlažniji i topliji.
Postoji ozbiljna moguænost | da se život razvio
i u vruæim izvorima na Marsu. | Ali za paleontologa NASA-e
Jacka Farmera, postoji nešto | poticajnije u vruæim izvorima.
Za razliku od ostalih | vodenih okruženja
koja su možda postojala | na Marsu,
vruæi izvori gotovo uvijek | stvaraju dobre fosile
organizama | koji su ondje živjeli,
i ne treba vam mikroskop | da biste ih vidjeli.
Ovdje, na rubu ovoga | vruæega izvora,
postoji mjesto gdje se | mikroorganizmi, bakterije,
pretvaraju u fosile | pred našim oèima,
fosile kakve æemo | potražiti na Marsu.
Naranèasta podruèja | zapravo su kolonije bakterija.
Vide se zanimljive teksture | i strukture koje proizvode
rastuæi gore, prema svjetlu. | Opæenito mikroorganizmi
dobro uspijevaju u ovim | kipuæim vruæim izvorima,
ali voda je puna | otopljenih minerala,
i kako se hladi, | pogotovo gdje je plitko,
minerali se izdvajaju | iz otopine te oblažu organizme
i zarobljavaju ih dok su živi | u oblik nalik na mumije.
Nekoliko metara od toga izvora | cijela kolonija bakterija,
obložena mineralima, | osušila se i okamenila.
Strukture i uzorci, | vidljivi golim okom,
mogli bi preživjeti | milijardama godina.
Moramo se vratiti na Mars | i potražiti ovakva mjesta
jer su to mjesta gdje se | takav fosilni trag
vjerojatno oèuvao. | A to æe nam pomoæi
da odgovorimo na pitanja | o životu na Marsu.
Iako su vruæi izvori najbolje | mjesto za potragu za životom,
Farmer je skupljao i uzorke | velikih fosila
koji su se stvorili | u jezerima i rijekama.
Svi imaju | prepoznatljive uzorke
koje paleontolog | ne bi mogao ne prepoznati
kad bi doista hodao | površinom Marsa.
Mislim da imamo èvrste | geološke smjernice
koja su to mjesta gdje trebamo | tražiti tragove života.
Imat æemo još smjernica nakon | iduæih geoloških misija.
Ali veæ sam prilièno siguran, | èak na temelju
samih podataka s Vikinga, | da smo prepoznali
nekoliko važnih lokacija.
Ako je na Marsu bilo života, | koliko dugo je postojao
dok se Mars pretvarao | u hladni suhi planet?
Odgovor možda leži | u kanadskomu Arktiku,
650 km od sjevernoga pola. | Jedan od prvih èlanova
Mars Undergrounda je NASA-in | znanstvenik Chris McKay.
Pješèenjaèke strukture su | ovdje visoke par stotina m.
Uz biologa Emoryja Friedmana, | McKay je došao ovamo da vidi
kako je život na Marsu | mogao izgledati
u okrutno hladnim uvjetima.
Arktik je slièan vjerojatnim | uvjetima na Marsu
kad mu je klima poèela | granièno podržavati život.
Ovo je hladna pustinja. | Prosjeèna godišnja temperatura
jest dobrano ispod nule. | Pod nama je debeli permafrost.
Što je najvažnije, | podruèje je jako suho.
Malo snijega oko nas je | za ovo podruèje puno snijega.
Postavlja se pitanje može li | život ovdje preživjeti.
Može li se prilagoditi | ovim hladnim, suhim uvjetima?
Idemo vidjeti. Oprezno. | Snijeg je sklizak.
Pažljivo hodajte. Nije lako.
Ako ovdje ima života, krhak je | i teško ga je pronaæi.
Ako postoji, skrio se | pred nama ispod površine.
Nakon sati hodanja | bez znaka života,
McKay i kolege su stigli do | divnih pješèenjaèkih oblika.
Pogledaj ovaj.
U kamenu je iznenaðenje. | Pogledaj.
To je to. To smo tražili. To.
Crna i zelena pruga alga | bila je 2,5 mm ispod površine.
Ovdje, na Arktiku, jednostavni | organizmi uspijevaju u stijeni
na dubini gdje sunce još | prodire i oslobaða energiju,
a voda se može pohraniti | u kamenim porama.
Nevjerojatno je da ovaj kamen, | gledano s površine,
ne odaje znakove života, | ekosustava koji skriva.
Pa ipak, to je odlièan | primjer uspijevanja života
na vrlo hladnome, | vrlo suhome mjestu,
ovakvoj hladnoj pustinji | ili hladnoj pustinji na Marsu.
Danas je na Marsu vjerojatno | prehladno i presuho
da bi takvi organizmi | preživjeli.
Možemo naæi samo | njihove fosilne ostatke.
No može li život uspijevati | u nekomu drugomu okolišu?
Sve je zeleno. | Dobro. Spremit æemo.
Jedno od najvjerojatnijih | nalazišta mikroorganizama
na Marsu jest permafrost, | odnosno smrznuto tlo.
Na Južnomu polu | skupina znanstvenika buši
smrznutu vodu | 30 cm ispod površine
u kojoj se nalazi kolonija | živuæih bakterija.
Ako podzemni svijet | mikroorganizama èuèi
pod Marsovom površinom, | jesu li i veæi oblici života
nekoæ ondje postojali?
Ako usporedimo povijest | Marsa i povijest Zemlje,
ne možemo oèekivati da se | ondje razvilo išta
složenije od mikroorganizama. | No možda ima razloga
za vjerovanje da je Mars bio | mnogo brži
na svojoj evolucijskoj putanji | u odnosu na Zemlju.
Možda su se na Marsu razvili | višestanièni organizmi
u kraæemu vremenskomu | razdoblju nego na Zemlji.
Mars je manji. | Možda je evolucija bila brža.
Možda je brže razvio | kisik u atmosferi. Tko zna?
Sve su to nagaðanja. | A kako æemo ih provjeriti?
Naravno, tako da odemo na Mars | i potražimo fosile.
Posada bi provela 18 mj. | Na Marsu, istražujuæi teren.
Mislim da æemo biti ondje | za 2 sata.
Za svaki sluèaj, | hodaju u parovima.
Istraživat æe dno | negdašnjih jezera,
gdje su stijene kanjona | presjek milijuna godina
povijesti Marsa. Možda otkriju | tragove negdašnjega života.
Ništa.
Paleontolozi se èesto | izlažu opasnostima
kako bi došli do najboljih | nalazišta fosila na Zemlji.
Na Marsu æe biti isto.
Moglo bi biti nesreæa, | ljudi bi mogli nastradati.
Ali to su rizici koje su ljudi | uvijek prihvaæali
kad su istraživali nepoznato.
Svi rizici dolaska dovde | mogli bi se isplatiti
na spektakularan naèin.
U ovakvomu bi kamenu moglo | biti neporecivih dokaza
da su kolonije biæa nalik | bakterijama živjele na Marsu.
U tom sluèaju, svemir za nas | više nikada neæe biti isti.
Sa svakim novim danom | bit æe novih otkriæa,
novih moguænosti istraživanja. | Struènjaci za Mars vjeruju
da bi posada mogla naæi | podzemni led
koji bi se mogao otopiti | i dati vodu.
Takvo bi otkriæe moglo | promijeniti buduænost Marsa,
što je san koji sanjaju | i pisci znanstvene fantastike
i znanstvenici. | Chris McKay iz NASA-e
vjeruje da možemo uèiniti | klimu crvenoga planeta
pogodnom za život | postupkom teraformiranja.
Doslovno, stvaranje neèega | nalik Zemlji, teraformiranje.
U osnovi, Marsu nedostaje | uèinak staklenika.
Poput staklenih ploèa | u stakleniku, ugljièni dioksid
i voda u atmosferi zadržavaju | sunèevu energiju
i griju planet. | Marsova rijetka atmosfera
ne stvara gotovo nikakav | uèinak staklenika.
Prvo što moramo uèiniti je | poveæati gustoæu atmosfere,
nekako poveæati | uèinak staklenika.
Taj uèinak staklenika | prouzroèio bi zatopljenje,
potekla bi voda, a onda bi se | na Mars mogao donijeti život
koji bi preživio.
U svojemu laboratoriju | u Istraživaèkomu centru Ames
McKay je eksperimentalno | ispitao izvedivost
jednoga moguæega naèina | poveæanja kolièine
staklenièkih plinova na Marsu. | Osnovno pitanje je može li
tlo biti izvor ugljiènoga | dioksida za atmosferu.
Mislimo da je nekoæ Mars imao | gustu atmosferu
ugljiènoga dioksida, ali da se | hlaðenjem planeta
ugljièni dioksid upio u tlo, | poput vode u spužvu.
Mislimo da bi se | zagrijavanjem planeta
ugljièni dioksid oslobodio i | stvorio gustu toplu atmosferu.
U svojemu eksperimentu McKay | simulira što se moglo dogoditi
Marsovom tlu | kako se planet hladio.
Najprije je izložio zemlju | neogranièenim kolièinama
ugljiènoga dioksida, onda je | ohladio tlo do ispod nule.
Nakon nekoliko dana, McKay | je zaustavio dotok plina,
prestao hladiti zemlju | i mjerio koliko se
ugljiènoga dioksida iz nje | oslobodilo zagrijavanjem.
Spektrometar mase otkrio je | ogromne kolièine.
Ali pokazalo se da bi, | ako hoæemo da Marsovo tlo
oslobodi ugljièni dioksid, | trebalo zagrijati Mars za 40°C
u odnosu na sadašnju | temperaturu od -80°C.
Ako uèinimo ono | što sada èinimo na Zemlji,
u atmosferu ispustimo | staklenièke plinove
i super-staklenièke plinove | poput klorofluorougljika,
ako to èinimo na Marsu | neko dulje vrijeme,
lako bismo postigli | zatopljenje od 40°C.
Takva bi promjena, naravno, | na Zemlji bila pogubna,
ali na Marsu bi bila upravo | po receptu lijeènika.
Da bi zapoèeo teraformiranje, | Chris Mckay predlaže da se
na Marsu postave tvornice | koje bi proizvodile
moæne staklenièke plinove. | Kako bi se oni nakupljali
u atmosferi, | Marsov uèinak staklenika
dramatièno bi se poveæao. | Više sunèeve energije
ostajalo bi u atmosferi | i temperature bi rasle.
Za 100 g. Možda bi | ugljièni dioksid poèeo
izlaziti iz tla, èime bi se | oslobodio još jedan
moæan staklenièki plin | i podigla temperatura.
Uskoro bi se tijekom | Marsovih ljeta
otopila voda na polovima. | Kako bi dio nje isparavao,
još jedan moæni staklenièki | plin, vodena para,
bi ušla u atmosferu. | Temperatura bi se povisila
dovoljno da tekuæe vode bude | tijekom cijele godine
i Mars bi postao | puno slièniji Zemlji.
To je ono što æe ljudi | moæi uèiniti na Marsu.
Bob Zubrin | Pioneer Astronautics
Moæi æemo pretvoriti Mars | u živi planet.
Dok æe prvi naseljenici | na Marsu živjeti u limenkama,
za 100 g. Æe živjeti | u kupolama,
a za par tisuæljeæa | na otvorenim livadama
i meðu šumama | teraformiranoga Marsa.
Mislim da je život dobar | i da je širenje života
sa Zemlje na druga mjesta | Sunèevoga sustava,
a i dalje, pozitivna stvar.
Današnji Mars je | nepoæudan za život,
bez tekuæe vode | i hladniji, èak i ljeti,
od najhladnijih temperatura | na Zemlji.
No tijekom prve ljudske | misije na Mars,
posada bi mogla izvesti | važan test teraformiranja
da vidi može li se klima | na Marsu promijeniti.
Podignu li staklenik | koji hvata toplinu sunca,
saznat æe uzrokuje li | podizanje temperature
oslobaðanje ugljiènoga | dioksida, staklenièkoga plina
iz tla, prema predviðanjima | Chrisa McKaya.
Nakon nekoliko dana, | vratili bi se do staklenika
i izmjerili kolièinu | ugljiènoga dioksida.
Ako je poveæanje veliko, | znaèi da teraformiranje Marsa,
njegovo 'pozemljavanje' | nije nemoguæe.
Kad ljudi zakoraèe | na crveni planet,
snovi bi se mogli | pretvoriti u stvarnost.
Ali koji æe se | snovi ostvariti?
Hoæemo li ondje | izgraditi naseobine?
Hoæe li Mars postati prošireni | svijet na kojemu danas živimo?
Mislim da æe za 200, 300, | 400 g. Postojati
zemaljska civilizacija | koja æe naseljavati Mars.
Bit æe djece, Marsovaca | drugoga naraštaja,
koja æe govoriti, | 'Hej, moji djed i baka
Gene Cernin | Astronaut Apolla
iz n-toga su stoljeæa | došli sa Zemlje.'
To æe biti odnos, | odnos Zemlje i Marsa,
nalik na odnos stare zemlje | i novoga svijeta
koji je ovdje bio prisutan | u posljednja 3, 4 stoljeæa.
Ako uspostavimo civilizaciju | na Marsu, to æe biti poticaj
za daljnji napredak | meðuplanetarnoga prijevoza.
Kao što je Kolumbo preplovio | Atlantik trima brodovima
projektiranima za Sredozemlje, | a nitko zdravoga razuma
ni za 100 g. Ne bi bio | pokušao takvo što,
kad su ljudi saznali | da postoji nešto zanimljivo
s druge strane Atlantika, | imali su poticaj
za napredak arhitekture | brodova.
I tako smo od karaka došli | do Clipper brodova,
pa do parnih brodova, | pa do Boeinga 747.
To æe se dogoditi i s Marsom.
Uvijek nam je bilo prirodno | da sanjamo o nemoguæemu.
Uskoro æemo poslati prve ljude | na površinu Marsa,
sigurno i ekonomièno, | tehnologijom koja je
danas gotovo veæ spremna. | Kad ljudi doðu
na crveni planet, mogli bismo | napokon odgovoriti
na mnoga dugogodišnja pitanja. | Zašto je Mars postao
tako hladan i suh? Koliko je | vode ostalo na planetu?
Je li ikada postojao život | na Marsu?
Ima li sada ondje života? | Sigurno æe biti iznenaðenja,
otkriæa koja ne možemo | ni zamisliti
dok èekamo da odredište | postane Mars.
 drdamjan  
